111111111111111111111111111111
100E00000000000000000001110001
111111100000000000000000111111
11111111100000011000000000C001
111111000000110110000111001111
1P0C000000110000C1000100100111
111111111111111111111111111111
