111111111111111111111111111111
100E0000000000000000000C111001
1111111000000C00000C0000111111
111111111000000110000000000001
111111000000110110000111001111
1P0000000011000001000100100111
111111111111111111111111111111
