11111111111111111111
1P0000N00000C0000001
10001111110011110001
1C0000000000100C0001
10111111111111110001
10000000C000000001C1
1000C001111000111111
1000000C00000C000001
11111000111111111101
100C000000000000C001
10000011111111000001
10000C000N000C000001
10111110000011111001
1000000C000000000C11
100001111111111000E1
11111111111111111111
